5 10 
XXXXXXXXXX
I       XX
XXX XXX XX
X   X    X
XXXXXXXXSX